A cappella: ah cuh'pelluh
Consummate: 'consuh-mate as v.
Consummate: 'consuh-muht as n.
Papa: 'papa
Flagrant: flay-gruhnt
Blatant: blay-tuhnt
Fragrant: fray-grant
Panacea: pana'see-uh
miscellany: 'misuhlaynee
something: sump'n
nothing: nut'n
getting: get'n
subsidy: 'subsuhdie
ophthalmologist: ofthuh'mologist
gauge: ga-dge
tournament: ter-nuh-ment
aunt: ant or ahnt
parental: puh'rental
cicada: cih-kay-duh
suspicion: suspition
impudent: 'impuduhnt
Norwegian: nor-'wee-gian
Venice: veh-nis
contact: 'kon-tact for both noun and verb
report: re'port for both noun and verb
restoration: restuhration
Swedish: swee-dish
imbecile: imbuh-sl
sesame: sehsihmee
latex: lay-tex
customary: custuh-mery
Czech: same as check
ferment: fuh-'ment
acrophobia: akruh-phobia
glossophobia: glossuh-phobia
arachnophobia: 'aruhknuh-phobia
claustrophobia: clau-struh-phobia
aerophobia: air-ruh-phobia
werewolf: where-wolf
chauffeur: 'show-fuh
jalapeno: haluh'pay-nio
nacho: nah-cho
quesadilla: kay-suh-'dee-uh
Neil: neel
cha-cha: chah-chah
comrade: 'com-rad (in American English)
